14
26
5 5 5 5 5 5 5 1 1 1 1 40 35 35 35 35 35 35 35 35 35 35 35 35 35 35
5 0 0 0 0 0 5 1 1 1 40 0 0 0 0 0 0 0 0 0 0 0 0 0 0 55
5 0 0 0 0 0 0 10 1 1 55 0 0 0 0 0 0 0 0 0 0 0 0 0 0 55
5 0 0 -1 0 0 0 10 1 1 50 0 0 0 0 0 0 0 0 0 0 0 0 0 0 55
5 0 0 0 0 0 0 15 1 40 0 0 0 0 0 0 0 0 0 0 0 0 0 0 0 55
5 0 0 0 0 0 0 0 15 25 0 0 0 0 0 60 0 0 0 0 0 0 0 0 0 55
5 0 0 0 0 0 0 0 15 25 0 0 0 0 50 60 0 0 0 0 0 0 0 0 0 55
5 0 0 0 0 0 0 0 20 0 0 0 0 0 45 1 70 0 0 0 0 0 0 0 0 65
5 0 0 0 0 0 0 0 0 0 0 0 0 0 40 1 70 0 0 0 0 0 0 0 0 65
5 0 0 0 0 0 0 0 0 0 0 0 0 40 1 1 1 75 0 0 0 0 0 0 0 65
5 0 0 0 0 0 0 0 0 0 0 0 0 35 1 1 1 1 80 0 0 0 0 0 0 76
5 0 0 0 0 0 0 0 0 0 0 0 30 1 1 1 1 1 80 0 0 0 0 0 0 76
5 0 0 0 0 0 0 0 0 0 0 25 1 1 1 1 1 1 85 0 0 0 0 0 0 79
5 5 5 10 10 15 15 20 20 20 25 25 1 1 1 1 1 1 90 95 95 95 100 100 95 95